11111111111111111111
1E0000000C0100000001
11111111000101011111
10000101000100010M01
1P01000000000M0000C1
11111111111111111111