111111111111111
1P1000001000001
101110101011111
101000101010001
101011101M10101
101010101010101
1C10101C1010101
100010C01000101
11111C111111101
100010000000001
1C1111111111101
100000000010001
101111101110111
101111101110111
1000001000000E1
111111111111111