111111111111111
1P1000C01000C01
10111C101011111
101000101010101
101C11101C000C1
101010101010101
1C10101C10101C1
100010C01000101
11111C111111101
1000100C00C00C1
1C1111111111101
10C000000C10001
101C00M00000101
101101101010111
10C0C01010C00E1
111111111111111