1111111111111111111
10000P1000001000001
1010000C00001000001
1000C000M0C0100C001
1111110000000011101
1C1000C00000C010001
1000C010C00000000M1
1111001000C00001111
10M00010110000E0011
1111111111111111111