111111111111111
1E00C0000000001
1M00P1110000001
111111111111111