1111111111111111111111
100P0000000000C0000E01
1000000000000000000001
10000000001000C00000011
1111111111111111111111