111111
1P0001
1C0001
100E01
111111