I pass this map : 

1111111111111111111111
100P0000000000C0000E01
1000000000000000000001
10000000001000C0000001
1111111111111111111111

➜  so_long git:(main) ✗ ./so_long ./maps/basic.ber
Error
Map is not rectangular.
