111111111
1000000C1
1M00P0000
111111111