111111111
1E0P000C1
1M0000P01
111111111