111111111
1E00000C1
1M00P00 1
111111111