111111111
1E00000C1
1M0000001
111111111