111111111
1E00000C1
1M00P000100001
111111111