111111111
1000000C1
1M00P0001
111111111