111111111
1E00000C1
1M00P0001

111111111