111111111
1E00000C1
1M00P0001
100000001
1M0000001
100000001
1M0000001
1M0000001
111111111