111111111
1E00000P1
1M0000001
111111111